XXXXXXXXXX
X0C 5E D1X
X   XX   X
XX XXXXXXX
XX XXXXXXX
X   XX   X
X3B 4F A2X
XXXXXXXXXX