XXXXXXXXXXXXXXXXXXXXX   XXXXXXXXXXXXXXXXXXXXX
XXXXXXXXXXXXXXXXXXXXX   XXXXXXXXXXXXXXXXXXXXX
XXXXXXXXXXXXXXXXXXXXX   XXXXXXXXXXXXXXXXXXXXX
XXXXXXXXXXXXXXXXXXXXX   XXXXXXXXXXXXXXXXXXXXX
XXXXXXXXXXXXXXXXXXXXX   XXXXXXXXXXXXXXXXXXXXX
XXXXXXXXXXXXXXXXXXXXX   XXXXXXXXXXXXXXXXXXXXX
XXXXXXXXXXXXXXXXXXXXX   XXXXXXXXXXXXXXXXXXXXX
XXXXXXXXXXXXXXXXXXXXX   XXXXXXXXXXXXXXXXXXXXX
XXXXXXXXXXXXXXXXXXXXX   XXXXXXXXXXXXXXXXXXXXX
XXXXXXXXXXXXXXXXXXXXX   XXXXXXXXXXXXXXXXXXXXX
XXXXXXXXXXXXXXXXXXXXX   XXXXXXXXXXXXXXXXXXXXX
XXXXXXXXXXXXXXXXXXXXX   XXXXXXXXXXXXXXXXXXXXX
XXXXXXXXXXXXXXXXXXXXX   XXXXXXXXXXXXXXXXXXXXX
XXXXXXXXXXXXXXXXXXXXX   XXXXXXXXXXXXXXXXXXXXX
XXXXXXXXXXXXXXXXXXXXX   XXXXXXXXXXXXXXXXXXXXX
XXXXXXXXXXXXXXXXXXXXX   XXXXXXXXXXXXXXXXXXXXX
XXXXXXXXXXXXXXXXXXXXX   XXXXXXXXXXXXXXXXXXXXX
XXXXXXXXXXXXXXXXXXXXX   XXXXXXXXXXXXXXXXXXXXX
XXXXXXXXXXXXXXXXXXXXXX XXXXXXXXXXXXXXXXXXXXXX
XXXXXXXXXXXXXXXXXXX       XXXXXXXXXXXXXXXXXXX
XXXXXXXXXXXXXXXXXXX       XXXXXXXXXXXXXXXXXXX
                  X       X                  
                                             
                  X       X                  
XXXXXXXXXXXXXXXXXXX       XXXXXXXXXXXXXXXXXXX
XXXXXXXXXXXXXXXXXXX       XXXXXXXXXXXXXXXXXXX
XXXXXXXXXXXXXXXXXXXXXX XXXXXXXXXXXXXXXXXXXXXX
XXXXXXXXXXXXXXXXXXXXX   XXXXXXXXXXXXXXXXXXXXX
XXXXXXXXXXXXXXXXXXXXX   XXXXXXXXXXXXXXXXXXXXX
XXXXXXXXXXXXXXXXXXXXX   XXXXXXXXXXXXXXXXXXXXX
XXXXXXXXXXXXXXXXXXXXX   XXXXXXXXXXXXXXXXXXXXX
XXXXXXXXXXXXXXXXXXXXX   XXXXXXXXXXXXXXXXXXXXX
XXXXXXXXXXXXXXXXXXXXX   XXXXXXXXXXXXXXXXXXXXX
XXXXXXXXXXXXXXXXXXXXX   XXXXXXXXXXXXXXXXXXXXX
XXXXXXXXXXXXXXXXXXXXX   XXXXXXXXXXXXXXXXXXXXX
XXXXXXXXXXXXXXXXXXXXX   XXXXXXXXXXXXXXXXXXXXX
XXXXXXXXXXXXXXXXXXXXX   XXXXXXXXXXXXXXXXXXXXX
XXXXXXXXXXXXXXXXXXXXX   XXXXXXXXXXXXXXXXXXXXX
XXXXXXXXXXXXXXXXXXXXX   XXXXXXXXXXXXXXXXXXXXX
XXXXXXXXXXXXXXXXXXXXX   XXXXXXXXXXXXXXXXXXXXX
XXXXXXXXXXXXXXXXXXXXX   XXXXXXXXXXXXXXXXXXXXX
XXXXXXXXXXXXXXXXXXXXX   XXXXXXXXXXXXXXXXXXXXX
XXXXXXXXXXXXXXXXXXXXX   XXXXXXXXXXXXXXXXXXXXX
XXXXXXXXXXXXXXXXXXXXX   XXXXXXXXXXXXXXXXXXXXX
XXXXXXXXXXXXXXXXXXXXX   XXXXXXXXXXXXXXXXXXXXX
