XXXX XXXXXXXX XXXXXXXX XXXXXXXX XXXXXXXX XXXX
XXX   XXXXXX   XXXXXX   XXXXXX   XXXXXX   XXX
XX  X  XXXX  X  XXXX  X  XXXX  X  XXXX  X  XX
   XXX      XXX      XXX      XXX      XXX   
XX  X  XXXX  X  XXXX  X  XXXX  X  XXXX  X  XX
XXX   XXXXXX   XXXXXX   XXXXXX   XXXXXX   XXX
XXXX XXXXXXXX XXXXXXXX XXXXXXXX XXXXXXXX XXXX
XXXX XXXXXXXX XXXXXXXX XXXXXXXX XXXXXXXX XXXX
XXX   XXXXXX   XXXXXX   XXXXXX   XXXXXX   XXX
XX  X  XXXX  X  XXXX  X  XXXX  X  XXXX  X  XX
   XXX      XXX      XXX      XXX      XXX   
XX  X  XXXX  X  XXXX  X  XXXX  X  XXXX  X  XX
XXX   XXXXXX   XXXXXX   XXXXXX   XXXXXX   XXX
XXXX XXXXXXXX XXXXXXXX XXXXXXXX XXXXXXXX XXXX
XXXX XXXXXXXX XXXXXXXX XXXXXXXX XXXXXXXX XXXX
XXX   XXXXXX   XXXXXX   XXXXXX   XXXXXX   XXX
XX  X  XXXX  X  XXXX  X  XXXX  X  XXXX  X  XX
   XXX      XXX      XXX      XXX      XXX   
XX  X  XXXX  X  XXXX  X  XXXX  X  XXXX  X  XX
XXX   XXXXXX   XXXXXX   XXXXXX   XXXXXX   XXX
XXXX XXXXXXXX XXXXXXXX XXXXXXXX XXXXXXXX XXXX
XXXX XXXXXXXX XXXXXXXX XXXXXXXX XXXXXXXX XXXX
XXX   XXXXXX   XXXXXX   XXXXXX   XXXXXX   XXX
XX  X  XXXX  X  XXXX  X  XXXX  X  XXXX  X  XX
   XXX      XXX      XXX      XXX      XXX   
XX  X  XXXX  X  XXXX  X  XXXX  X  XXXX  X  XX
XXX   XXXXXX   XXXXXX   XXXXXX   XXXXXX   XXX
XXXX XXXXXXXX XXXXXXXX XXXXXXXX XXXXXXXX XXXX
XXXX XXXXXXXX XXXXXXXX XXXXXXXX XXXXXXXX XXXX
XXX   XXXXXX   XXXXXX   XXXXXX   XXXXXX   XXX
XX  X  XXXX  X  XXXX  X  XXXX  X  XXXX  X  XX
   XXX      XXX      XXX      XXX      XXX   
XX  X  XXXX  X  XXXX  X  XXXX  X  XXXX  X  XX
XXX   XXXXXX   XXXXXX   XXXXXX   XXXXXX   XXX
XXXX XXXXXXXX XXXXXXXX XXXXXXXX XXXXXXXX XXXX